R  640 480

NO ./Textures/jungle_1.xpm
SO ./Textures/jungle_2.xpm
WE ./Textures/jungle_3.xpm
EA ./Textures/jungle_4.xpm

S ./Textures/sprite_1.xpm
F 127, 96, 0
C 111, 168, 220



        1111111111111111111111111
        1000000000110000000000001
        1011000001110000002000001
        1001000000000000000000001
111111111011000001110000000000001
100000000011000001110111111111111
11110111111111011100000010001
11110111111111011101010000001
11000000110101011100000000001
10002000000000001100000010001
10000000000000001101010000001
11000001110101011111011110N0111
11110111 1110101 101111010001
11111111 1111111 111111111111
