R  640  480

NO ./Textures/jungle_1.xpm
SO ./Textures/jungle_2.xpm
WE ./Textures/jungle_3.xpm
EA ./Textures/jungle_4.xpm

S ./Textures/sprite_1.xpm
S ./Textures/tiger_1.xpm
F 127, 96, 0
C 111, 168, 220



        1111111111111111111111111
        1000020200110003200000001
        1011002000110020002000001
        1001000000000000000032001
111111111011000000110000000002001
100000000011000001110111111111111
11110111111111011100000012201
11110111111111011101010222031
11200000110131011100000222301
13000000200200001100000012201
10000000000000001101010000001
11000001110101011111011110N0111
11110111 1113121 101111010001
11111111 1111111 111111111111




