R  640  480

NO ./Textures/jungle_1.xpm
SO ./Textures/jungle_2.xpm
WE ./Textures/jungle_3.xpm
EA ./Textures/jungle_4.xpm

S ./Textures/sprite_1.xpm
S ./Textures/tiger_1.xpm
F 127, 96, 0
C 111, 168, 220




    11111111
    12022001
    12300001
    11111001
        1001
        1001111111111111111111111   111111
        1000020203110000200020001111100021
        1011002000110020S02000000000003011
        100101110000000000000230111111111
11111111101101 100110000300002001
1000000000110111001110111111111111
11110111111111011100000013231
11110111111111011101010232001
11200000113101011103000232001
10000200200200031100000012201
10020000000000001101010000001
11000001110101011111011110111
11003111 1110101 101111010001
10011111 1111111 111111111111
10211
10021
11111



